   1 KILLING	Conflict_Attack ; Life_Die
   1 Murder	Conflict_Attack ; Life_Die
   1 deaths	Conflict_Attack ; Life_Die
   1 killers	Conflict_Attack ; Life_Die
   1 manslaughter	Conflict_Attack ; Life_Die
   1 murders	Conflict_Attack ; Life_Die
   2 blew	Conflict_Attack ; Life_Die
   2 genocide	Conflict_Attack ; Life_Die
   2 kills	Conflict_Attack ; Life_Die
   2 slaughter	Conflict_Attack ; Life_Die
   4 murdering	Conflict_Attack ; Life_Die
   5 killings	Conflict_Attack ; Life_Die
   7 massacre	Conflict_Attack ; Life_Die
  14 killing	Conflict_Attack ; Life_Die
  19 killed	Conflict_Attack ; Life_Die
  23 murder	Conflict_Attack ; Life_Die
  27 kill	Conflict_Attack ; Life_Die
   1 ABUSE	Conflict_Attack ; Life_Injure
   1 abuse	Conflict_Attack ; Life_Injure
   1 assault	Conflict_Attack ; Life_Injure
   1 assaulted	Conflict_Attack ; Life_Injure
   1 hurt	Conflict_Attack ; Life_Injure
   1 rape	Conflict_Attack ; Life_Injure
   1 shooting	Conflict_Attack ; Life_Injure
   1 shot	Conflict_Attack ; Life_Injure
   1 wounding	Conflict_Attack ; Life_Injure
   2 attacks	Conflict_Attack ; Life_Injure
   2 injured	Conflict_Attack ; Life_Injure
   2 injuring	Conflict_Attack ; Life_Injure
   4 knee-capping	Conflict_Attack ; Life_Injure
   1 robbery	Conflict_Attack ; Transaction_Transfer-Money
   1 hijackings	Conflict_Attack ; Transaction_Transfer-Ownership
   1 robbery	Conflict_Attack ; Transaction_Transfer-Ownership
   1 seized	Conflict_Attack ; Transaction_Transfer-Ownership
   2 robbed	Conflict_Attack ; Transaction_Transfer-Ownership
   3 burglary	Conflict_Attack ; Transaction_Transfer-Ownership
   1 ruled	Contact_Broadcast ; Justice_Trial-Hearing
   1 receive	Contact_Correspondence ; Transaction_Transfer-Ownership
   1 received	Contact_Correspondence ; Transaction_Transfer-Ownership
   3 Apprehension	Contact_Meet ; Justice_Arrest-Jail
   1 pleaded	Contact_Meet ; Justice_Trial-Hearing
   1 told	Contact_Meet ; Justice_Trial-Hearing
   5 testimony	Contact_Meet ; Justice_Trial-Hearing
   1 visited	Contact_Meet ; Movement_Transport-Person
   1 hand	Contact_Meet ; Transaction_Transfer-Ownership
   1 charged	Justice_Charge-Indict ; Justice_Charge-Indict
   1 charges	Justice_Charge-Indict ; Justice_Charge-Indict
   1 Hangs	Justice_Execute ; Life_Die
   1 execute	Justice_Execute ; Life_Die
   1 executes	Justice_Execute ; Life_Die
   1 executing	Justice_Execute ; Life_Die
   1 execution	Justice_Execute ; Life_Die
   1 executions	Justice_Execute ; Life_Die
   2 hanged	Justice_Execute ; Life_Die
   2 hung	Justice_Execute ; Life_Die
   2 lethal	Justice_Execute ; Life_Die
   8 death	Justice_Execute ; Life_Die
  10 executed	Justice_Execute ; Life_Die
   1 deport	Justice_Extradite ; Movement_Transport-Person
   1 extradites	Justice_Extradite ; Movement_Transport-Person
   6 deported	Justice_Extradite ; Movement_Transport-Person
   6 extradite	Justice_Extradite ; Movement_Transport-Person
   8 extradition	Justice_Extradite ; Movement_Transport-Person
  24 extradited	Justice_Extradite ; Movement_Transport-Person
   1 fining	Justice_Fine ; Transaction_Transfer-Money
   4 fined	Justice_Fine ; Transaction_Transfer-Money
   5 fine	Justice_Fine ; Transaction_Transfer-Money
   1 sentenced	Justice_Sentence ; Justice_Sentence
   1 supplying	Movement_Transport-Artifact ; Transaction_Transaction
   2 smuggling	Movement_Transport-Artifact ; Transaction_Transfer-Money ; Transaction_Transfer-Ownership
   3 trafficking	Movement_Transport-Artifact ; Transaction_Transfer-Money ; Transaction_Transfer-Ownership
   1 pick	Movement_Transport-Artifact ; Transaction_Transfer-Ownership
   1 sending	Movement_Transport-Artifact ; Transaction_Transfer-Ownership
   1 shipping	Movement_Transport-Artifact ; Transaction_Transfer-Ownership
   1 smugglers	Movement_Transport-Artifact ; Transaction_Transfer-Ownership
   1 supplied	Movement_Transport-Artifact ; Transaction_Transfer-Ownership
   2 Smuggling	Movement_Transport-Artifact ; Transaction_Transfer-Ownership
   2 receiving	Movement_Transport-Artifact ; Transaction_Transfer-Ownership
   2 supply	Movement_Transport-Artifact ; Transaction_Transfer-Ownership
   2 trafficking	Movement_Transport-Artifact ; Transaction_Transfer-Ownership
   2 transfer	Movement_Transport-Artifact ; Transaction_Transfer-Ownership
   3 smuggleing	Movement_Transport-Artifact ; Transaction_Transfer-Ownership
   4 smuggle	Movement_Transport-Artifact ; Transaction_Transfer-Ownership
   4 smuggling	Movement_Transport-Artifact ; Transaction_Transfer-Ownership
   1 former	Personnel_End-Position ; Personnel_End-Position
   1 worked	Personnel_End-Position ; Personnel_End-Position ; Personnel_End-Position
   1 pay	Transaction_Transfer-Money ; Transaction_Transfer-Money
   1 buyers	Transaction_Transfer-Money ; Transaction_Transfer-Ownership
   1 donated	Transaction_Transfer-Money ; Transaction_Transfer-Ownership
   1 purchase	Transaction_Transfer-Money ; Transaction_Transfer-Ownership
   1 purchased	Transaction_Transfer-Money ; Transaction_Transfer-Ownership
   1 running	Transaction_Transfer-Money ; Transaction_Transfer-Ownership
   1 sell	Transaction_Transfer-Money ; Transaction_Transfer-Ownership
   1 selling	Transaction_Transfer-Money ; Transaction_Transfer-Ownership
   2 bought	Transaction_Transfer-Money ; Transaction_Transfer-Ownership
   2 buyer	Transaction_Transfer-Money ; Transaction_Transfer-Ownership
   2 sold	Transaction_Transfer-Money ; Transaction_Transfer-Ownership
   4 sales	Transaction_Transfer-Money ; Transaction_Transfer-Ownership
   5 Sell	Transaction_Transfer-Money ; Transaction_Transfer-Ownership
   1 Death Penalty	Justice_Execute ; Life_Die
   1 scythed down	Conflict_Attack ; Life_Die
   1 attempted murder	Conflict_Attack ; Life_Die
   2 running over	Conflict_Attack ; Life_Injure
   3 death penalty	Justice_Execute ; Life_Die
   1 capital punishment	Justice_Execute ; Life_Die
   1 the slaying	Conflict_Attack ; Life_Die
   2 put to death	Justice_Execute ; Life_Die
